#################################################################################################
#.          #     #         #     #       #           #   #   #       #                 #       #
# ####### # # # # # ### ##### # ### # # # # ######### # # # # # # ### # ######### ### # # ### # #
#     #   #     #       #     #     #   #   #     #   # #   #   # # #   # #     #   # #   # #   #
### ### ######### ####### ################### ### # ### ##### ##### ##### # ### ##### ##### ### #
# # #   #   #     #     #         #       #   #   # #       # #     #   # #   #   #   #     #   #
# # # ### ### ####### # # # ##### # # ### # ##### # ####### # # ### # # # ### ### # ### # ### ###
# # #   # #       #   # # # #     #       # #   #   #     # # #   #         #       #   #     # #
# # ### # # # ### # ### ### # # ##### ### # # # ##### # ### # ### ####### # ##### ##### ####### #
# # #         #       #     #       # #   # # #       #   #     # #         #   #   #         # #
# # # ######### # # ##### ##### # # # # ### # ########### ##### # # ##### # # ##### # # ##### # #
#   # #     #     #       #   #   #   # #     #     #     #   # #       # #     #       #   #   #
##### # ### # # ########### # ##### # # # # ### ### # ####### # # # # # # # ### # ####### # ### #
#     # # # # #   #         #     #     # # #     # # #       #   #   # # #   # # #         #   #
# ##### # # ####### ########### # ### ### ### ### ### # # ### ### ##### # # # # # # ### ### #####
# #       #             #       #   #   #   # #       # # #       #     #   # # #     # # #     #
# # # ### ######### ### ### # ### # ### # # # ### ##### # # ### ### ### ### # # # ####### ### # #
#     #   # #         # #   #     #   # # #     #   #       #   #     #   # #   #   #     #   # #
# ### # ### # ######### # ####### ##### # # ####### ##### ### ##### # ### # # ### ### ### # ### #
#     #     #   # #     #       #         # #     #     # #   #     # #   # #   #     #   #   # #
# ######### ### # # ######### # ########### # ### # ### # # ##### ### # # # ### # ##### # ### ###
#         # # #   # #           #   #   #   # #   # #   # # #     # # #   # #   # #   # #   #   #
# ### ##### # ### # # # ##### ### ### # # # # # ### # ### # # # ### # ##### # ### # # # # # ### #
#   #       #   #   # # #   # #   #   # #   # #     # #   # #   #   # #     #       # #   # #   #
# # ####### # ######### # # # ### # # # ### # ### ### # # # # ### # # # ##### ##### ### # # ### #
#     #   # #           # # #     # # #   #   #       # #   #   # #     #   #   # # #   # # #   #
##### # ##### # # ### ### ##### ### # # ### # # # ##### ####### # # # ### # ### # # # ### # # # #
#   # # # #   # #     #   # #   #   # # #     # #   #   #         #     # #   # #   #   # #   # #
# ### # # # ### ####### ### # ### ### # # ##### ### ### # ### ### # # # # # ### ####### # # #####
# #   #       #   #           #     # #   #   #   # # # #   # #   #     # #           # # # #   #
# # ### ### ### ### ### ####### # # # ##### # ### # # # ### # # # ### ### ### # ##### # # # # # #
#       #       #             # #   #             #           # #     #       # #       #     #  
#################################################################################################

