###############################################################################################################################################################################################################################################
#.  #     #               #         #                 # #         #   #     #           #   #       #   #           #     # #       # #         #     #   #       #     #     #                                     # #   #           #       #
# ### ### # ### # # # ### # # ##### ### ##### ##### ### # ### # # # # # # # # ##### ### # # # ##### # # ######### # ##### # ### # # # # ####### # # # # # # ##### ### # ### # ####### ##### ######### ### ######### # # # # ### # ##### # ### #
# #   #   #   #   #   #   #     #     # # #       # #         # #   #   # # #     # # #     #     #   #           # #           # # #   #     # # #     #   #   #     #   # #     #   #         #     #       #     #         # #     # #   # #
# # ### ##### ######### ##### # # # ### # # ##### # ### # ### # ######### # # ##### # ##### ##### ################# # ### ### ### # # ### # # # # # ### # ### # # ##### ### ##### # ########### # ##### ##### # # ##### ####### ##### # ### # #
# # # #   # #         #       #   #     # # #   #     # # #   # #       # #   #     #     #     #       #   #     #   # #     #     # #     #   #     # # #   # #     #           #         #     #     #   # # #   #   #       #     #   #   #
# # # ### # ######### ####### ####### ### # # ### ##### # ##### # ##### # # ### ####### ##### ######### # # ##### ##### ####### ### ### ##### ### ##### ### # # ### # ##### ############### ##### # ### # # # # ### # # # ####### # ####### # #
# #   # #   #   #         #         #     # #           # #     # #   #   #     #     #     #   #   #   # # #               #   #     #   #   #       #           #   #   #         #     #   #   # #     #   #   #   # # #   #   # # #   # # #
# ### # ### # # # ### ### # # ##### ##### # ### # ####### # ##### # # ############# # ### # ### # ### ### # # ### # ### ##### ### ### ### # ### ##### # ######### # # # # ##### # # ##### ### ##### # # ### ### # ##### # # # # ### # # # # # #
#   # #   #   #   # #   #   # #       #   #   # # #     #   # #   # # #   #   #   # # #   #   # #         # # # # # # #   # # # #     #       #     # # #   #     # #   #     #   #         #       # # #   #   # #   #   # # #   #     # # # #
# ### # ### # ##### ### ##### # ### # # ##### ### ### # ##### # ### # # # ### # # # # # # ##### # # # # ### # # # # # ### # # # ####### ##### ### # # # # # # ##### # ######### ######### # # # ##### # # ### ### # # ##### ##### # ##### # # #
# #     # # # #       #   #       #   # #       #     #       #   # #   #       #   #   # #   # # # # # # #   #   # # #     # #       #     #   #       # #     #   # # #       #   #   #     # #     # #     #     #   #       #   # #   # # #
# # ##### # # ### ### # ##### # # ### # # ##### ####### ##### # ### ######### # # ### ##### # # # ### ### ##### ### # # ### # ### ### # ### ##### ### ### ####### ##### # ####### # # # # ##### # ### # # ##### # # # # # ##### ##### # ##### #
#   #           #   # # #     # #       #     #       #           # #       # # # #   #   #     # #                   #   # #     # #     #       # #   #     #               #   #   #       # # #   # #       #   # # # #           #     # #
# ### ######### # ### # # # ### # # ####### # ##### ##### ##### # # # ##### # ##### ### # ### ### # ### ##### # # # ##### ######### ### # ######### ### ##### # ### ######### # ####### # # # # ### ### ##### # ####### # # ### # # ####### # #
#   #           # #       # # # #   #       #   #       # #   # # #       # #     # #   #   #   # #   #         # #   # #           #     #   #       #     # # #     #   #   #       # # # #         # #     #   #   #   #   # # # #       # #
### ##### ####### ##### ### # # ### # ### # # ### ##### # # # # # ### ### # ### # # # ##### # ### ### # ########### ### # ### ####### # ### # # ### # # ### # # # # ### # ##### # ### # ### # ##### # # # # ### # # # ##### # # # # # ####### #
# #     # #       #   # #   # #   # #       #   #     #   # # # # #     #   #   # # # #   #       #   #   #   #     #   # #   #       # #       #   # #   # #           #           # #   # # # #   # # # # #   # #       # # # # # #   #     #
# ### # ### # ##### # # # ### ### ############# ##### ### # # ### # # # # ### ### ### # # ### ### # ### # # # # ####### ### # # ####### ##### # # ### ### ##### ### ########### # # # ### # # # # ### # # # ##### # # # # ### ### # ### # ### #
# #                 #   # #     # #         #         # #   #     #   #     # # #     #     # # #     #     # #       #     #   #     # #     #   # #         #   # #   #     #   # #     #   # #   #   # #   #   # #   #   #             #   #
# # ### ### ######### # # ### # # # ####### ########### ### ######### ##### # # ####### ### # # ### # # ##### ##### ### # # # ### ### # # ##### ### ### ### # ### # # # ##### ##### ####### ### # ####### ### # ### ####### ####### # # # # # #
#   #   # #           # #   #     # # #   #     #       #   #   # # #       #   #     #   # #   #   #   #   # #     #     # # #   # # # #         # #   #         #   #       #       #   #           #   #   #   #           #   # # # # #   #
# ### ### ##### ##### # # # # # ### # # # ##### # ##### ### # ### # ### ####### # # ##### # ### # ##### # # # # ##### ### ##### ### # # ##### # ### # # ##### ### ########### # ### ### # # # # # ### # # # # ### # ### ##### # # # ####### ###
# #   #     #   #   # #   # # # #   # # #         # # #       #         #   #   #   #   # # #   # #     #         # #           #   # #       # #         #   #   # #         #   # #   #   #   #         # # #       #   # # # # #   #     # #
# # ### ### # ### # ### # # ### # # # # ##### ##### # ##### ### # ### ### # # ### # # # # ### ### # # # ### ##### # ##### ### ### ### ####### # ##### ##### # ##### # ######### # # # ############### ##### ### ######### # # ### # # # ##### #
# # #       #   # #   # # #   #     # #     #         #     #   #   # #   # # #   #   # #   # # # # # #   #       #       #   # #       #   # #   # #   #   # #     # #   #     #       #       #   # # #   # #         # #     # # # # #     #
# # # # ### # # # # ##### # # ####### ##### ##### # # # ### # ### # ### ### # # ##### # # # # # # ### ### ######### ### # # ### # ####### # # ### # ##### ##### ### # # # ##### ### ### # ##### # # # # # ### ######### # ##### # ### # # # # #
# # # # #   #     #       # # #   #       #     # # # #       #     #     #   # #   # # # #           # # #     #   #   #     #       #   #   # # #   #       # # #     # #       # # # #   #     #   #             #     #     #   #         #
# # ### ##### # ############# # # ##### # ### ### # ####### ### # ### ### ##### # # ### ### ### # ##### # ### ### ### ##### # ####### # ####### # # # ####### # # ### # # # ### ### # # # # ### ####### # ### ### ######### ### ### ####### # #
#     #   #     #             # # #   #   #   #   # #     # # # # #     # #   #   # #         # #     #           #     #   #     #   #   #     #   #           #   # # #           # # # # #   #         #   # # #       # # #     #     # # #
# ### # # # # ### ### ### ### # # # # # ### ### # ### ### # # # ### ### # # # ##### # ##### # ####### ### ### ##### # # # # ##### # # ### ##### ####### ### ####### ### ##### # # ### # # # # # # ##### ### ### # # ### # # # ### # # # # ### #
# #   #   # #   # #   # # #   # #   #   #     # # #   #   #   #   # #   #         #         #   #   #   # #         #   # # #   # #   #               # #   # #   # #     #   #     #     #   # #     # #   #     # # #   # #   # #     #     #
# # ##### # ### ### # # # ### ####### # # # # # ### ### ### ##### ### ### ### ####### # ########### ### ############# # # ##### # ##### ####### # # ### ### # ### # ### ### ### ### # ##### ######### # # # # # ### # ### # # ### ####### #####
#       #     # #   #   #       #   # #   #   #       #   # #     # #   # #   #   #   # #         #   #   #       #   # # #     #       # #   # # # #   #         #     #   #     # # #                 # # # #   # #   #   # #     #         #
# ### ##### # # # ##### ##### # # ### # ################# # # ### # ### # ##### # # # ### ### ### # ##### # ##### # # # # # ############# ### # # # # # # # ### ######### ######### # # ######### ### # # # # ### # # # ##### # # ### # ##### #
#         #   #   # #   #     # #   # # #   #         #     # #       # # #     # # # #   # #       #   # #     #   # # #             #     #   # # # # # #     #         #         # # #       # #   # # #   #   # # #   #   # #     #   #   #
# ##### # # ### ### # ### ##### # # # # # ### ####### # # ### ##### # # # # ##### ### # ### # ### # # # # # ### ### ### # # ##### ##### ### # ### # # # # ####### # ####### ### ##### # # ##### # # ##### # ### # # # # ### ### # ### ##### ###
#   # # #       #     #   #     # # # #   #   #   #   #     #     #   # # #   #         #     #   #   #   #   #   # #     # #   #     #   # #     # # #   #       #   #     #   #   # # # # #   # #     # # # #       # #   #   #   # #   #   #
### # # ### # # # # ##### ### ### ### ####### # # # # # # # ##### ### # # ### ####### ### ##### ########### # ### # # # # ### # ##### ### # ### # ### # # # ##### # ### ### ##### # # # # # ##### ##### # # # ########### # ##### # # # ##### #
#     # #   #   #       # # #       #     #     # # # # # #     # #   # #   #   # #   #     #         #   #     #     # #     #       #       # # #   # # # #   #   #     #       #                 # #         #         #     # #         # #
####### # ##### ####### # # # ### ####### # # ### ### # ### ##### # # # # ### ### # # # ### ##### ##### # # ### ### # # ### ######### # ##### # # # ### # # ### ##### # # ####### # # # # ####### # # # # ### ### # ####### ### # # ####### # #
#       #   # #   # #   # # # #       # #   #   #     #     #     # #   # #   #   # # #     # #   #     # # #     # # #     #   #     #   #   #   #     #   #           #           # # # #     #   #   # #   #   # #       #   # # #     #   #
# ### ##### # ### # # ### # # # # # # # ####### ############# # ##### ### # ### # ### ##### # # ### ##### # # ### # # ##### # # ### ##### ### ######### ##### ####### ############### # # ##### ### # ### # ### ##### ####### ### ### # # #####
# # # #     #       #         # # # # #       # #               #   # # #   #   #   # #   #   #       #   #   #   # #     #   #   #     #   #         #       # #       #         #   # #     # #   #   # # # #     # #       #   #   # #     #
# # # # # ### ### ##### ##### # ### # ##### ### # ######### ##### # # # # ### ##### # # # ### ######### ### ### ### # # # ####### # ### ### ######### # # ##### # ### # # ####### # ### ##### # # ##### # # # ##### # ### ##### # # ######### #
#   # # # #   #   #   # #   # #   #         #   #   #             #   # #   # #   #   # #         #     #     # #     #   #     # #     #     #     #   #     #   # #   #     # #     #       #   #   # #   # #     #   #     # # # #     #   #
# # # # ### ### # # # ### # ##### # # # ##### ##### # ################# # # # # # # ### # # # # # # ##### ### ### # # ### # ##### # ####### # # # ####### # # # ### ####### ### ############### ### # # # ### # ##### # ##### ### # # ### # # #
# # # #     # # # #         #     #   # #     #     # #       #       #   #   # # # #   #   # # # #     #   #     # #   # #     #   #   #       #     #   # #   #   #         #   #         # # #     # #     # #   #           #     # # # # #
# # ######### # ##### ### # # ##### ##### ##### # # # # # # # ### # # # # ##### # ### ####### # ####### ### ##### # # ### # ### ### # # ### # # # ### # ### ##### # # ##### # # # # # ### # # # # ### # # # ### # # # ### ### # # ##### # # ###
#       #       #       #     #   #             # # # #   # #     # # #   #     #     #     # #   #   #   #       #   #   #   #   # # #   # # # #   #   #       #           #   #   # #   #   # #   # # #       # #   #       #     #     #   #
##### # # ### # # ############# # ####### ##### # ### ##### ####### # ### # ########### ### # # # ### ### ### ### ##### # # # ### # # # # ### # # # ### # ### ### ### ####### ### ### # ### ### # # ### ### # ### ##### ####### ### # # ##### #
#   # # #     #   # #         # #       # #   # #   #       #         #           #     #   # #         # #       #   # # # #     #   #       #   #   #   #   #   # # #     #         #   # #   # # #   #   #   #   # # #   # # #   # #       #
# # # # # ### ##### ### # # # # ##### # ### # ##### ##### ### ####### # ### ### # # ### # ### # # ##### # ####### # ### ##### # ##### ####### ##### # # ### ### ### # ### ####### ##### # # # ##### ### # ### # # ### # # # # # # ### # ##### #
#     # # #     #     # # #     #     # #   #           # # #         #       #     #   #     # # #   # #   #       #   #   # # #       #     #     # #   # #   #     #   #     # # #   # # #   #     #   #   # #     # # # # #     #   #     #
# ##### ### ### # ### # # ####### ##### # ####### ######### ####### # ##### # ### # # # ######### # # # # # ######### # # # # # # ### ### ### ### ### ### # # ### ##### # # # # # # # # # # ### # ### ####### # ### ### # # # ### # ##### ### #
# #   # #   # # #   # #     #     #   #   #     # #     #   #     # #   #   #     # # # #   #   #   # #             #   # #   # # #     # #       #     #   #   # #     # #   #     # #   #   #   # #     #   # #   #   # # #     #   #       #
# # # # # ### # ### # ##### # ##### ##### # ### # # ### # ### # # # # # # # ####### # # # # # # ##### ### # ####### # # # ### # # # # # # # # # ##### # ### # # # ### ### ### # # ### ##### # ##### ##### # # ##### # ### # # ### ### # #######
#   #     # #   #   #   #         #             # # # #       # # #   # # #       #   # #     #       #   # #         # # #     # #   # #   #     # # #   #   # # #   #   #   #       #       #     #     # # #     #     # # #     # #   #   #
######### # ### # # ### # ### ### ####### ##### # # # ######### # ### ### # ##### ##### ### ##### ##### ### ####### ##### # ### ##### # ### ### ### ##### # ### # # ##### # ##### ##### # ####### # # ##### ### ##### ##### # # ##### # # # # #
#         # #   # # #   #   # #   #     # #   #   # #     #     #   # #   #           #   #   #   #   # #   #     # #     #   # #   # #   #     #         # #   #     #   #     #     #   #       # #   #   #   #   #       #     #   # #   # #
# ######### # ### ### ### ##### # # ### # # # ##### ### ### ### ### # # ####### # # # ### # # # ### # ### ### ### ### ####### ### # ### # ##### # ########### ##### # # # ### # ### # # ### # # ##### ### ### # # # # ####### ##### ##### ### #
# #     #       #     #   #     # # #   # # #     # #     #           #       # #   # #   # # # #   #         # #     #       #   #   # #     #   #     #           # # #   #     # #   #   # # #       #       # #   #     #   #       # #   #
# # # ### ##### # # ### ### ### ### # ##### ##### # # # # ##### # # # ### ### # ##### # ##### ### ####### ##### ####### ##### # ##### # ### # ##### ##### # # ### # ### # ##### ### # ### # # ### ### # # ##### # ##### # ##### # # # # # # # #
# #       #   #   #   #   # # # #   #           # # #   #       # #   # # #         # #   #   # # #               # #       # #   #   # # # # #     #     # # # #     # #     # #   # #       #   #     # #     #     # #     # #   #   # # # #
# ######### # # # ### ### # # ### ############# # # ### ##### ### ##### ### # ### # # ### # ### # ### # ######### # # ### ### ### ### # # # ##### # # ##### # # ### # # ### # # # ### ### # ### ######### ### # ##### # ##### # ##### ##### ###
#     #     # # # # #         #   #       #   # # #   #     #   #   #     # # #     # # #   #     #   #   #   #   #     #   #   #   # #   # #     #   #   #     # # # #     # # #         #   #         #   # # #           #   #   #     #   #
# ### # ##### ### # ######### # ### # # ### # ### ### # ### ### ### # ### # # ####### # ##### ##### ### ### # # ### # # ### ### # ### ### # # # ####### # ####### # # ### ### # ### ##### ### ### ##### # ### ### ### # ######### # ##### # ###
# #         # #   #     #     # # # # # #           #     #   # #   # # #   #       # #     # #       #     #     # # #         # #     # #   #               #     #     # # # # #     # #     # # #   #       #     #         # #   #   #   #
# # ######### # ### ##### ### # # ### # ##### ##### ##### # # # # ### # ### ####### # # ### # ### ### # ##### ### ### ##### # ### ### ####### ### ######### # # # ######### # # # ##### # # ####### # ####### # ######### ##### # # # # ### # #
# # #       # # #   # #   #       #   #   #   #   #   #   #   # # # #     #   # #     # #   #   # #         # #     #   #   # #   # # #       #         # # # # # #         # # #     # # #   #               #       # #     # # # #   #   # #
# # ### ### # # # ### # ##### # # # ##### # ### # ##### # # ### # # ### # # # # # # ### ####### # ########### ##### ### # ##### ### # # ##### # # # ### # # # # # # ##### # ### ##### # # # # # ####### ### # # ####### ####### # # ##### ### #
#     #       # # #     #   # # #   #   # #     # #   # # # #   #     # # # #   #   #       #   #   #   #   #   # #   #     #       # # #   #   #   #   #     # # # #   # # #         #     # #   #     # # #   #     #       # #     #   #   #
### # ### ##### # # ##### # ### ##### ### ### # # # # # # # # # ### # ### # ### ##### # # # # ####### # # # ### # ### # # ### # ### # # # # ####### # # ####### # # ### # ### # ##### ####### ### # ##### # # ### ### # # ### # ##### ##### # #
#                 #       #     #           #   #   #   #     #     #       #         # #   #             #     #       #     #     #           #   #           #       #       #           #       #             #     # #     #           #  
###############################################################################################################################################################################################################################################
